"noc","edition","bronze","silver","gold","total"
"AUS",1896,0,0,2,2
"AUT",1896,2,1,2,5
"DEN",1896,3,2,1,6
"FRA",1896,2,4,5,11
"GBR",1896,2,3,2,7
"GER",1896,2,5,26,33
"GRE",1896,22,20,10,52
"HUN",1896,3,1,2,6
"SUI",1896,0,2,1,3
"USA",1896,2,7,11,20
"ZZX",1896,2,2,2,6
"AUS",1900,3,0,2,5
"AUT",1900,3,3,0,6
"BEL",1900,15,19,5,39
"BOH",1900,1,1,0,2
"CAN",1900,1,0,1,2
"CUB",1900,0,1,1,2
"DEN",1900,2,3,1,6
"ESP",1900,0,0,2,2
"FRA",1900,53,86,46,185
"GBR",1900,10,20,48,78
"GER",1900,10,19,11,40
"HUN",1900,2,2,1,5
"IND",1900,0,2,0,2
"ITA",1900,0,2,2,4
"NED",1900,15,5,0,20
"NOR",1900,3,6,0,9
"SUI",1900,1,1,13,15
"SWE",1900,1,0,0,1
"USA",1900,14,14,27,55
"ZZX",1900,8,8,18,34
"AUT",1904,1,0,0,1
"CAN",1904,0,9,26,35
"CUB",1904,3,2,4,9
"GBR",1904,0,1,1,2
"GER",1904,5,4,4,13
"GRE",1904,1,0,1,2
"HUN",1904,1,1,2,4
"SUI",1904,1,0,1,2
"USA",1904,111,137,146,394
"ZZX",1904,0,5,3,8
"ANZ",1908,2,2,15,19
"AUT",1908,1,0,0,1
"BEL",1908,6,24,1,31
"BOH",1908,5,0,0,5
"CAN",1908,26,8,17,51
"DEN",1908,3,12,0,15
"FIN",1908,27,1,1,29
"FRA",1908,21,5,9,35
"GBR",1908,68,135,144,347
"GER",1908,7,11,4,22
"GRE",1908,0,3,0,3
"HUN",1908,5,7,6,18
"ITA",1908,0,5,2,7
"NED",1908,11,0,0,11
"NOR",1908,3,34,7,44
"RSA",1908,0,1,1,2
"RU1",1908,0,2,1,3
"SWE",1908,11,18,69,98
"USA",1908,15,14,34,63
"ANZ",1912,3,2,5,10
"AUT",1912,5,9,0,14
"BEL",1912,9,1,9,19
"CAN",1912,3,2,3,8
"DEN",1912,34,45,5,84
"FIN",1912,22,36,9,67
"FRA",1912,5,10,10,25
"GBR",1912,58,58,44,160
"GER",1912,23,19,10,52
"GRE",1912,1,0,1,2
"HUN",1912,3,17,10,30
"ITA",1912,2,1,18,21
"NED",1912,22,0,0,22
"NOR",1912,29,6,41,76
"RSA",1912,0,2,5,7
"RU1",1912,9,5,0,14
"SWE",1912,25,62,86,173
"USA",1912,31,25,45,101
"AUS",1920,1,5,0,6
"BEL",1920,65,66,57,188
"BRA",1920,5,1,1,7
"CAN",1920,3,3,10,16
"DEN",1920,1,44,30,75
"ESP",1920,0,24,0,24
"EST",1920,0,2,1,3
"FIN",1920,17,14,18,49
"FRA",1920,55,73,13,141
"GBR",1920,17,35,55,107
"GRE",1920,0,5,0,5
"ITA",1920,7,9,68,84
"JPN",1920,0,3,0,3
"LUX",1920,0,1,0,1
"NED",1920,24,10,14,48
"NOR",1920,27,56,58,141
"NZL",1920,1,0,0,1
"RSA",1920,6,12,3,21
"SUI",1920,21,2,6,29
"SWE",1920,57,36,53,146
"TCH",1920,10,0,0,10
"USA",1920,38,45,110,193
"ARG",1924,2,3,6,11
"AUS",1924,2,5,3,10
"AUT",1924,1,3,0,4
"BEL",1924,6,29,3,38
"CAN",1924,1,19,0,20
"DEN",1924,2,8,2,12
"EST",1924,4,1,1,6
"FIN",1924,15,13,24,52
"FRA",1924,20,63,39,122
"GBR",1924,20,29,17,66
"HAI",1924,7,0,0,7
"HUN",1924,8,10,2,20
"ITA",1924,21,5,25,51
"JPN",1924,1,0,0,1
"NED",1924,17,1,8,26
"NOR",1924,3,7,16,26
"NZL",1924,1,0,0,1
"POL",1924,1,4,0,5
"POR",1924,3,0,0,3
"ROU",1924,23,0,0,23
"RSA",1924,1,1,1,3
"SUI",1924,21,31,13,65
"SWE",1924,49,25,6,80
"TCH",1924,5,4,1,10
"URU",1924,0,0,22,22
"USA",1924,51,37,110,198
"YUG",1924,0,0,2,2
"ARG",1928,5,24,3,32
"AUS",1928,1,2,1,4
"AUT",1928,2,0,2,4
"BEL",1928,4,1,0,5
"CAN",1928,21,5,7,33
"CHI",1928,0,1,0,1
"DEN",1928,3,5,5,13
"EGY",1928,1,1,2,4
"ESP",1928,0,0,3,3
"EST",1928,6,1,2,9
"FIN",1928,9,8,8,25
"FRA",1928,13,16,7,36
"GBR",1928,24,25,6,55
"GER",1928,39,13,20,72
"HAI",1928,0,1,0,1
"HUN",1928,0,11,9,20
"IND",1928,0,0,15,15
"IRL",1928,0,0,1,1
"ITA",1928,31,21,18,70
"JPN",1928,1,5,2,8
"NED",1928,6,39,20,65
"NOR",1928,1,4,4,9
"NZL",1928,0,0,1,1
"PHI",1928,1,0,0,1
"POL",1928,14,3,1,18
"RSA",1928,5,0,1,6
"SUI",1928,5,8,16,29
"SWE",1928,21,8,7,36
"TCH",1928,2,12,2,16
"URU",1928,0,0,22,22
"USA",1928,17,24,43,84
"YUG",1928,10,1,1,12
"ARG",1932,0,1,3,4
"AUS",1932,1,1,3,5
"AUT",1932,3,1,1,5
"CAN",1932,23,13,2,38
"DEN",1932,4,5,0,9
"ESP",1932,1,0,0,1
"FIN",1932,16,8,5,29
"FRA",1932,6,8,23,37
"GBR",1932,14,12,8,34
"GER",1932,5,26,7,38
"HUN",1932,8,4,20,32
"IND",1932,0,0,11,11
"IRL",1932,0,0,2,2
"ITA",1932,18,38,21,77
"JPN",1932,4,17,10,31
"LAT",1932,0,1,0,1
"MEX",1932,0,2,0,2
"NED",1932,0,10,2,12
"NZL",1932,0,2,0,2
"PHI",1932,3,0,0,3
"POL",1932,14,3,2,19
"RSA",1932,3,0,2,5
"SUI",1932,0,1,0,1
"SWE",1932,12,7,12,31
"TCH",1932,1,2,1,4
"URU",1932,1,0,0,1
"USA",1932,59,44,78,181
"ARG",1936,4,2,5,11
"AUS",1936,1,0,0,1
"AUT",1936,4,41,5,50
"BEL",1936,12,0,0,12
"CAN",1936,9,12,1,22
"DEN",1936,3,3,0,6
"EGY",1936,2,1,2,5
"EST",1936,3,2,2,7
"FIN",1936,13,6,7,26
"FRA",1936,18,13,12,43
"GBR",1936,8,16,12,36
"GER",1936,59,63,88,210
"HUN",1936,16,1,25,42
"IND",1936,0,0,19,19
"ITA",1936,5,30,36,71
"JPN",1936,8,4,9,21
"LAT",1936,1,1,0,2
"MEX",1936,16,0,0,16
"NED",1936,21,7,9,37
"NOR",1936,15,12,1,28
"NZL",1936,0,0,1,1
"PHI",1936,1,0,0,1
"POL",1936,4,5,0,9
"POR",1936,3,0,0,3
"ROU",1936,0,2,0,2
"RSA",1936,0,1,0,1
"SUI",1936,24,22,1,47
"SWE",1936,16,11,7,34
"TCH",1936,0,12,5,17
"TUR",1936,1,0,1,2
"USA",1936,15,26,51,92
"YUG",1936,0,1,0,1
"ARG",1948,1,8,3,12
"AUS",1948,5,9,2,16
"AUT",1948,3,0,1,4
"BEL",1948,8,2,4,14
"BRA",1948,12,0,0,12
"CAN",1948,5,1,0,6
"CUB",1948,0,2,0,2
"DEN",1948,27,15,7,49
"EGY",1948,1,2,2,5
"ESP",1948,0,3,0,3
"FIN",1948,7,7,15,29
"FRA",1948,21,22,25,68
"GBR",1948,11,39,6,56
"HUN",1948,21,24,15,60
"IND",1948,0,0,20,20
"IRI",1948,1,0,0,1
"ITA",1948,12,31,20,63
"JAM",1948,0,2,1,3
"KOR",1948,2,0,0,2
"MEX",1948,4,1,4,9
"NED",1948,32,2,8,42
"NOR",1948,11,4,3,18
"PAN",1948,2,0,0,2
"PER",1948,0,0,1,1
"POL",1948,1,0,0,1
"POR",1948,3,2,0,5
"PUR",1948,1,0,0,1
"RSA",1948,1,1,2,4
"SRI",1948,0,1,0,1
"SUI",1948,5,22,5,32
"SWE",1948,29,15,29,73
"TCH",1948,3,3,14,20
"TRI",1948,0,1,0,1
"TUR",1948,2,4,6,12
"URU",1948,2,1,0,3
"USA",1948,35,30,83,148
"YUG",1948,0,16,0,16
"ARG",1952,2,2,2,6
"AUS",1952,11,2,7,20
"AUT",1952,2,1,0,3
"BEL",1952,0,3,4,7
"BRA",1952,2,0,1,3
"BUL",1952,1,0,0,1
"CAN",1952,0,3,1,4
"CHI",1952,0,4,0,4
"DEN",1952,5,1,3,9
"EGY",1952,1,0,0,1
"ESP",1952,0,1,0,1
"FIN",1952,29,3,8,40
"FRA",1952,16,9,14,39
"GBR",1952,26,2,3,31
"GER",1952,26,14,0,40
"HUN",1952,32,17,52,101
"IND",1952,1,0,14,15
"IRI",1952,4,3,0,7
"IRL",1952,0,1,0,1
"ITA",1952,15,21,17,53
"JAM",1952,0,3,5,8
"JPN",1952,2,9,1,12
"KOR",1952,2,0,0,2
"LIB",1952,1,1,0,2
"LUX",1952,0,0,1,1
"MEX",1952,0,1,0,1
"NED",1952,0,18,0,18
"NOR",1952,0,8,5,13
"NZL",1952,2,0,1,3
"POL",1952,1,2,1,4
"POR",1952,2,0,0,2
"ROU",1952,2,1,1,4
"RSA",1952,4,8,2,14
"SUI",1952,12,19,2,33
"SWE",1952,23,24,23,70
"TCH",1952,10,4,11,25
"TRI",1952,2,0,0,2
"TUR",1952,1,0,2,3
"URS",1952,19,62,36,117
"URU",1952,14,0,0,14
"USA",1952,28,23,79,130
"VEN",1952,1,0,0,1
"YUG",1952,0,20,4,24
"ARG",1956,1,1,0,2
"AUS",1956,26,12,23,61
"AUT",1956,4,0,0,4
"BAH",1956,2,0,0,2
"BEL",1956,0,2,0,2
"BRA",1956,0,0,1,1
"BUL",1956,14,3,1,18
"CAN",1956,5,9,5,19
"CHI",1956,2,2,0,4
"DEN",1956,1,5,1,7
"EUA",1956,22,23,12,57
"FIN",1956,22,1,3,26
"FRA",1956,13,13,6,32
"GBR",1956,22,15,8,45
"GRE",1956,1,0,0,1
"HUN",1956,14,20,30,64
"IND",1956,0,0,17,17
"IRI",1956,1,2,2,5
"IRL",1956,3,1,1,5
"ISL",1956,0,1,0,1
"ITA",1956,10,11,25,46
"JPN",1956,5,15,4,24
"KOR",1956,1,1,0,2
"MEX",1956,1,0,1,2
"NOR",1956,2,0,1,3
"NZL",1956,0,0,3,3
"PAK",1956,0,14,0,14
"POL",1956,9,9,1,19
"ROU",1956,10,3,6,19
"RSA",1956,7,0,0,7
"SUI",1956,3,0,0,3
"SWE",1956,6,14,14,34
"TCH",1956,1,5,1,7
"TUR",1956,2,2,3,7
"URS",1956,55,46,68,169
"URU",1956,12,0,0,12
"USA",1956,20,37,61,118
"YUG",1956,0,23,0,23
"ARG",1960,1,3,0,4
"AUS",1960,9,17,10,36
"AUT",1960,0,2,1,3
"BEL",1960,2,2,0,4
"BRA",1960,13,0,0,13
"BUL",1960,3,3,1,7
"BWI",1960,5,0,0,5
"CAN",1960,0,9,0,9
"DEN",1960,4,17,2,23
"EGY",1960,1,1,0,2
"ESP",1960,14,0,0,14
"ETH",1960,0,0,1,1
"EUA",1960,21,33,34,88
"FIN",1960,4,1,1,6
"FRA",1960,5,6,0,11
"GBR",1960,15,11,2,28
"GHA",1960,0,1,0,1
"GRE",1960,0,0,3,3
"HUN",1960,36,16,13,65
"IND",1960,0,13,0,13
"IRI",1960,3,1,0,4
"IRQ",1960,1,0,0,1
"ITA",1960,34,18,36,88
"JPN",1960,10,10,9,29
"MAR",1960,0,1,0,1
"MEX",1960,1,0,0,1
"NED",1960,2,1,0,3
"NOR",1960,0,0,2,2
"NZL",1960,1,0,2,3
"PAK",1960,1,0,13,14
"POL",1960,15,11,4,30
"POR",1960,0,2,0,2
"ROU",1960,11,1,3,15
"RSA",1960,2,1,0,3
"SIN",1960,0,1,0,1
"SUI",1960,6,5,0,11
"SWE",1960,3,2,2,7
"TCH",1960,11,7,4,22
"TPE",1960,0,1,0,1
"TUR",1960,0,2,7,9
"URS",1960,45,63,61,169
"USA",1960,21,23,68,112
"VEN",1960,1,0,0,1
"YUG",1960,0,1,16,17
"ARG",1964,0,1,0,1
"AUS",1964,29,5,8,42
"BAH",1964,0,0,2,2
"BEL",1964,1,0,2,3
"BRA",1964,12,0,0,12
"BUL",1964,2,5,3,10
"CAN",1964,1,2,2,5
"CUB",1964,0,1,0,1
"DEN",1964,4,1,7,12
"ETH",1964,0,0,1,1
"EUA",1964,49,44,22,115
"FIN",1964,2,0,3,5
"FRA",1964,17,13,1,31
"GBR",1964,5,19,4,28
"GHA",1964,1,0,0,1
"HUN",1964,7,7,42,56
"IND",1964,0,0,15,15
"IRI",1964,2,0,0,2
"IRL",1964,1,0,0,1
"ITA",1964,9,28,13,50
"JPN",1964,27,5,32,64
"KEN",1964,1,0,0,1
"KOR",1964,1,2,0,3
"MEX",1964,1,0,0,1
"NED",1964,16,9,5,30
"NGR",1964,1,0,0,1
"NZL",1964,2,0,4,6
"PAK",1964,0,16,0,16
"PHI",1964,0,1,0,1
"POL",1964,25,13,10,48
"ROU",1964,10,4,2,16
"SUI",1964,1,4,1,6
"SWE",1964,8,4,3,15
"TCH",1964,12,38,5,55
"TRI",1964,5,1,0,6
"TUN",1964,1,1,0,2
"TUR",1964,1,3,2,6
"URS",1964,50,63,61,174
"URU",1964,1,0,0,1
"USA",1964,36,36,78,150
"YUG",1964,2,11,2,15
"ARG",1968,2,0,0,2
"AUS",1968,10,34,5,49
"AUT",1968,3,2,0,5
"BEL",1968,2,1,0,3
"BRA",1968,3,1,0,4
"BUL",1968,3,21,2,26
"CAN",1968,4,3,3,10
"CMR",1968,0,1,0,1
"CUB",1968,0,10,0,10
"DEN",1968,6,6,4,16
"ETH",1968,0,1,1,2
"FIN",1968,1,2,1,4
"FRA",1968,10,5,12,27
"FRG",1968,18,15,16,49
"GBR",1968,5,5,8,18
"GDR",1968,19,19,13,51
"GRE",1968,1,0,0,1
"HUN",1968,29,20,32,81
"IND",1968,15,0,0,15
"IRI",1968,2,1,2,5
"ITA",1968,19,8,5,32
"JAM",1968,0,1,0,1
"JPN",1968,22,29,16,67
"KEN",1968,2,7,3,12
"KOR",1968,1,1,0,2
"MEX",1968,3,3,3,9
"MGL",1968,3,1,0,4
"NED",1968,1,7,6,14
"NOR",1968,0,2,4,6
"NZL",1968,2,0,5,7
"PAK",1968,0,0,13,13
"POL",1968,30,2,5,37
"ROU",1968,9,9,5,23
"SUI",1968,10,3,0,13
"SWE",1968,1,4,4,9
"TCH",1968,15,7,7,29
"TPE",1968,1,0,0,1
"TUN",1968,1,0,1,2
"TUR",1968,0,0,2,2
"UGA",1968,1,1,0,2
"URS",1968,60,62,66,188
"USA",1968,35,31,83,149
"VEN",1968,0,0,1,1
"YUG",1968,2,14,13,29
"ARG",1972,0,1,0,1
"AUS",1972,2,7,11,20
"AUT",1972,2,1,0,3
"BEL",1972,0,2,0,2
"BRA",1972,2,0,0,2
"BUL",1972,6,10,6,22
"CAN",1972,8,2,0,10
"COL",1972,2,1,0,3
"CUB",1972,18,1,3,22
"DEN",1972,0,0,1,1
"ESP",1972,1,0,0,1
"ETH",1972,2,0,0,2
"FIN",1972,6,1,3,10
"FRA",1972,15,5,2,22
"FRG",1972,36,17,43,96
"GBR",1972,12,9,8,29
"GDR",1972,56,62,30,148
"GHA",1972,1,0,0,1
"GRE",1972,0,2,0,2
"HUN",1972,25,46,10,81
"IND",1972,14,0,0,14
"IRI",1972,1,2,0,3
"ITA",1972,13,3,9,25
"JAM",1972,1,0,0,1
"JPN",1972,8,19,29,56
"KEN",1972,4,3,5,12
"KOR",1972,0,1,0,1
"LIB",1972,0,1,0,1
"MEX",1972,0,1,0,1
"MGL",1972,0,1,0,1
"NED",1972,2,1,3,6
"NGR",1972,1,0,0,1
"NIG",1972,1,0,0,1
"NOR",1972,4,2,2,8
"NZL",1972,1,4,9,14
"PAK",1972,0,15,0,15
"POL",1972,11,8,27,46
"PRK",1972,13,1,1,15
"ROU",1972,27,10,3,40
"SUI",1972,0,8,0,8
"SWE",1972,8,9,4,21
"TCH",1972,6,21,2,29
"TUN",1972,0,1,0,1
"TUR",1972,0,1,0,1
"UGA",1972,0,1,1,2
"URS",1972,58,46,107,211
"USA",1972,43,59,53,155
"YUG",1972,2,1,15,18
"AUS",1976,8,16,0,24
"AUT",1976,1,0,0,1
"BEL",1976,6,3,0,9
"BER",1976,1,0,0,1
"BRA",1976,3,0,0,3
"BUL",1976,18,13,8,39
"CAN",1976,12,8,0,20
"CUB",1976,14,4,6,24
"DEN",1976,5,0,3,8
"ESP",1976,0,6,0,6
"FIN",1976,0,2,4,6
"FRA",1976,8,7,5,20
"FRG",1976,30,24,21,75
"GBR",1976,11,15,6,32
"GDR",1976,42,51,99,192
"HUN",1976,35,6,14,55
"IRI",1976,1,1,0,2
"ITA",1976,4,25,2,31
"JAM",1976,0,1,1,2
"JPN",1976,10,6,25,41
"KOR",1976,15,1,1,17
"MEX",1976,1,0,1,2
"MGL",1976,0,1,0,1
"NED",1976,13,2,0,15
"NOR",1976,0,4,2,6
"NZL",1976,9,1,17,27
"PAK",1976,16,0,0,16
"POL",1976,26,29,18,73
"POR",1976,0,2,0,2
"PRK",1976,0,1,1,2
"PUR",1976,1,0,0,1
"ROU",1976,23,28,4,55
"SUI",1976,6,3,1,10
"SWE",1976,0,1,9,10
"TCH",1976,9,4,2,15
"THA",1976,1,0,0,1
"TRI",1976,0,0,1,1
"URS",1976,79,93,113,285
"USA",1976,36,56,63,155
"VEN",1976,0,1,0,1
"YUG",1976,3,14,2,19
"AUS",1980,5,2,5,12
"AUT",1980,1,3,1,5
"BEL",1980,0,0,1,1
"BRA",1980,5,0,4,9
"BUL",1980,40,46,8,94
"CUB",1980,5,7,8,20
"DEN",1980,2,2,4,8
"ESP",1980,3,19,2,24
"ETH",1980,2,0,2,4
"FIN",1980,5,1,3,9
"FRA",1980,6,5,18,29
"GBR",1980,22,18,5,45
"GDR",1980,61,87,112,260
"GRE",1980,4,0,1,5
"GUY",1980,1,0,0,1
"HUN",1980,40,13,8,61
"IND",1980,0,0,16,16
"IRL",1980,1,2,0,3
"ITA",1980,8,21,8,37
"JAM",1980,3,0,0,3
"LIB",1980,1,0,0,1
"MEX",1980,11,1,0,12
"MGL",1980,2,2,0,4
"NED",1980,5,1,0,6
"POL",1980,22,25,3,50
"PRK",1980,2,3,0,5
"ROU",1980,50,15,7,72
"SUI",1980,0,0,2,2
"SWE",1980,9,6,3,18
"TAN",1980,0,2,0,2
"TCH",1980,16,18,18,52
"UGA",1980,0,1,0,1
"URS",1980,123,127,192,442
"VEN",1980,0,1,0,1
"YUG",1980,17,27,13,57
"ZIM",1980,0,0,16,16
"ALG",1984,2,0,0,2
"AUS",1984,29,14,7,50
"AUT",1984,1,1,1,3
"BEL",1984,2,2,1,5
"BRA",1984,2,34,1,37
"CAN",1984,32,35,19,86
"CHN",1984,37,13,26,76
"CIV",1984,0,1,0,1
"CMR",1984,1,0,0,1
"COL",1984,0,1,0,1
"DEN",1984,10,5,0,15
"DOM",1984,1,0,0,1
"EGY",1984,0,1,0,1
"ESP",1984,3,14,2,19
"FIN",1984,6,2,4,12
"FRA",1984,31,16,21,68
"FRG",1984,52,74,31,157
"GBR",1984,43,20,9,72
"GRE",1984,1,1,0,2
"IRL",1984,0,1,0,1
"ISL",1984,1,0,0,1
"ITA",1984,28,6,29,63
"JAM",1984,2,4,0,6
"JPN",1984,31,8,10,49
"KEN",1984,2,0,1,3
"KOR",1984,7,29,6,42
"MAR",1984,0,0,2,2
"MEX",1984,1,3,2,6
"NED",1984,14,6,20,40
"NGR",1984,4,1,0,5
"NOR",1984,3,1,0,4
"NZL",1984,6,1,16,23
"PAK",1984,0,0,16,16
"PER",1984,0,1,0,1
"POR",1984,2,0,1,3
"PUR",1984,1,1,0,2
"ROU",1984,35,31,40,106
"SUI",1984,6,9,0,15
"SWE",1984,11,18,3,32
"SYR",1984,0,1,0,1
"THA",1984,0,1,0,1
"TPE",1984,1,0,0,1
"TUR",1984,3,0,0,3
"USA",1984,50,115,168,333
"VEN",1984,3,0,0,3
"YUG",1984,35,5,47,87
"ZAM",1984,1,0,0,1
"AHO",1988,0,1,0,1
"ARG",1988,12,1,0,13
"AUS",1988,10,6,18,34
"AUT",1988,0,0,1,1
"BEL",1988,2,0,0,2
"BRA",1988,5,22,1,28
"BUL",1988,17,14,10,41
"CAN",1988,12,5,4,21
"CHI",1988,0,1,0,1
"CHN",1988,31,16,6,53
"COL",1988,1,0,0,1
"CRC",1988,0,1,0,1
"DEN",1988,3,1,3,7
"DJI",1988,1,0,0,1
"ESP",1988,2,2,1,5
"FIN",1988,2,1,1,4
"FRA",1988,13,4,12,29
"FRG",1988,44,37,32,113
"GBR",1988,15,16,22,53
"GDR",1988,47,52,75,174
"GRE",1988,1,0,0,1
"HUN",1988,15,9,20,44
"INA",1988,0,3,0,3
"IRI",1988,0,1,0,1
"ISV",1988,0,1,0,1
"ITA",1988,8,10,11,29
"JAM",1988,0,5,0,5
"JPN",1988,13,3,4,20
"KEN",1988,2,2,5,9
"KOR",1988,12,37,28,77
"MAR",1988,2,0,1,3
"MEX",1988,2,0,0,2
"MGL",1988,1,0,0,1
"NED",1988,36,5,3,44
"NOR",1988,0,21,2,23
"NZL",1988,16,4,4,24
"PAK",1988,1,0,0,1
"PER",1988,0,12,0,12
"PHI",1988,1,0,0,1
"POL",1988,10,9,2,21
"POR",1988,0,0,1,1
"ROU",1988,13,30,8,51
"SEN",1988,0,1,0,1
"SUI",1988,2,6,0,8
"SUR",1988,0,0,1,1
"SWE",1988,11,5,0,16
"TCH",1988,3,4,3,10
"THA",1988,1,0,0,1
"TUR",1988,0,1,1,2
"URS",1988,95,65,134,294
"USA",1988,52,64,77,193
"YUG",1988,21,27,15,63
"ALG",1992,1,0,1,2
"ARG",1992,2,0,0,2
"AUS",1992,16,27,14,57
"AUT",1992,0,6,0,6
"BAH",1992,1,0,0,1
"BEL",1992,2,1,0,3
"BRA",1992,0,1,13,14
"BUL",1992,7,7,3,17
"CAN",1992,12,5,27,44
"CHN",1992,19,46,18,83
"COL",1992,1,0,0,1
"CRO",1992,3,12,0,15
"CUB",1992,14,13,44,71
"DEN",1992,9,2,3,14
"ESP",1992,2,20,44,66
"EST",1992,2,0,1,3
"ETH",1992,2,0,1,3
"EUN",1992,66,65,92,223
"FIN",1992,2,4,1,7
"FRA",1992,43,5,9,57
"GBR",1992,39,3,8,50
"GER",1992,60,57,81,198
"GHA",1992,13,0,0,13
"GRE",1992,0,0,2,2
"HUN",1992,8,23,14,45
"INA",1992,1,3,2,6
"IOP",1992,2,1,0,3
"IRI",1992,2,1,0,3
"IRL",1992,0,1,1,2
"ISR",1992,1,1,0,2
"ITA",1992,14,10,22,46
"JAM",1992,1,3,0,4
"JPN",1992,36,8,3,47
"KEN",1992,2,4,2,8
"KOR",1992,16,5,28,49
"LAT",1992,1,2,0,3
"LTU",1992,12,0,1,13
"MAR",1992,1,1,1,3
"MAS",1992,2,0,0,2
"MEX",1992,0,1,0,1
"MGL",1992,2,0,0,2
"NAM",1992,0,2,0,2
"NED",1992,8,20,5,33
"NGR",1992,4,7,0,11
"NOR",1992,1,20,2,23
"NZL",1992,5,9,1,15
"PAK",1992,16,0,0,16
"PER",1992,0,1,0,1
"PHI",1992,1,0,0,1
"POL",1992,19,18,5,42
"PRK",1992,6,0,4,10
"PUR",1992,1,0,0,1
"QAT",1992,1,0,0,1
"ROU",1992,14,31,8,53
"RSA",1992,0,3,0,3
"SLO",1992,6,0,0,6
"SUI",1992,0,0,1,1
"SUR",1992,1,0,0,1
"SWE",1992,7,27,1,35
"TCH",1992,1,3,4,8
"THA",1992,1,0,0,1
"TPE",1992,0,20,0,20
"TUR",1992,2,2,2,6
"USA",1992,85,50,89,224
"ALG",1996,1,0,2,3
"ARG",1996,1,19,0,20
"ARM",1996,0,1,1,2
"AUS",1996,84,16,32,132
"AUT",1996,2,1,0,3
"AZE",1996,0,1,0,1
"BAH",1996,0,5,0,5
"BDI",1996,0,0,1,1
"BEL",1996,2,2,2,6
"BLR",1996,16,6,1,23
"BRA",1996,44,15,5,64
"BUL",1996,6,12,3,21
"CAN",1996,12,31,8,51
"CHN",1996,17,74,19,110
"CRC",1996,0,0,1,1
"CRO",1996,0,13,16,29
"CUB",1996,10,8,39,57
"CZE",1996,4,5,4,13
"DEN",1996,1,1,22,24
"ECU",1996,0,0,1,1
"ESP",1996,22,21,24,67
"ETH",1996,1,0,2,3
"FIN",1996,1,2,1,4
"FRA",1996,20,10,21,51
"GBR",1996,9,15,2,26
"GEO",1996,2,0,0,2
"GER",1996,47,35,42,124
"GRE",1996,0,4,4,8
"HKG",1996,0,0,1,1
"HUN",1996,26,9,8,43
"INA",1996,3,1,2,6
"IND",1996,1,0,0,1
"IRI",1996,1,1,1,3
"IRL",1996,1,0,3,4
"ISR",1996,1,0,0,1
"ITA",1996,28,24,19,71
"JAM",1996,12,3,1,16
"JPN",1996,14,26,3,43
"KAZ",1996,4,4,3,11
"KEN",1996,3,4,1,8
"KOR",1996,7,49,10,66
"LAT",1996,0,1,0,1
"LTU",1996,12,0,0,12
"MAR",1996,2,0,0,2
"MAS",1996,1,2,0,3
"MDA",1996,1,2,0,3
"MEX",1996,1,0,0,1
"MGL",1996,1,0,0,1
"MOZ",1996,1,0,0,1
"NAM",1996,0,2,0,2
"NED",1996,26,9,38,73
"NGR",1996,3,4,19,26
"NOR",1996,20,3,2,25
"NZL",1996,4,2,3,9
"PHI",1996,0,1,0,1
"POL",1996,7,7,7,21
"POR",1996,2,0,1,3
"PRK",1996,2,1,2,5
"PUR",1996,1,0,0,1
"ROU",1996,15,10,13,38
"RSA",1996,1,1,3,5
"RUS",1996,34,45,36,115
"SLO",1996,0,2,0,2
"SUI",1996,0,6,5,11
"SVK",1996,1,1,1,3
"SWE",1996,5,23,3,31
"SYR",1996,0,0,1,1
"TGA",1996,0,1,0,1
"THA",1996,1,0,1,2
"TPE",1996,0,1,0,1
"TRI",1996,2,0,0,2
"TUN",1996,1,0,0,1
"TUR",1996,1,1,4,6
"UGA",1996,1,0,0,1
"UKR",1996,19,5,10,34
"USA",1996,52,48,160,260
"UZB",1996,1,1,0,2
"YUG",1996,13,12,1,26
"ZAM",1996,0,1,0,1
"ALG",2000,3,1,1,5
"ARG",2000,3,17,0,20
"ARM",2000,1,0,0,1
"AUS",2000,54,69,60,183
"AUT",2000,0,1,3,4
"AZE",2000,1,0,2,3
"BAH",2000,0,0,6,6
"BAR",2000,1,0,0,1
"BEL",2000,4,3,0,7
"BLR",2000,11,8,3,22
"BRA",2000,36,12,0,48
"BUL",2000,2,6,5,13
"CAN",2000,23,4,4,31
"CHI",2000,18,0,0,18
"CHN",2000,17,23,39,79
"CMR",2000,0,0,18,18
"COL",2000,0,0,1,1
"CRC",2000,2,0,0,2
"CRO",2000,9,0,1,10
"CUB",2000,12,35,22,69
"CZE",2000,4,3,2,9
"DEN",2000,4,3,18,25
"ESP",2000,20,20,3,43
"EST",2000,2,0,1,3
"ETH",2000,3,1,4,8
"FIN",2000,1,1,3,5
"FRA",2000,14,30,22,66
"GBR",2000,13,20,22,55
"GEO",2000,6,0,0,6
"GER",2000,65,23,31,119
"GRE",2000,8,6,4,18
"HUN",2000,4,24,25,53
"INA",2000,2,4,2,8
"IND",2000,1,0,0,1
"IRI",2000,1,0,3,4
"IRL",2000,0,1,0,1
"ISL",2000,1,0,0,1
"ISR",2000,1,0,0,1
"ITA",2000,29,14,22,65
"JAM",2000,9,14,0,23
"JPN",2000,8,30,5,43
"KAZ",2000,0,4,3,7
"KEN",2000,2,3,2,7
"KGZ",2000,1,0,0,1
"KOR",2000,35,26,12,73
"KSA",2000,1,1,0,2
"KUW",2000,1,0,0,1
"LAT",2000,1,1,1,3
"LTU",2000,15,0,2,17
"MAR",2000,4,1,0,5
"MDA",2000,1,1,0,2
"MEX",2000,3,2,1,6
"MKD",2000,1,0,0,1
"MOZ",2000,0,0,1,1
"NED",2000,23,29,27,79
"NGR",2000,0,8,0,8
"NOR",2000,19,4,21,44
"NZL",2000,3,0,1,4
"POL",2000,7,10,7,24
"POR",2000,2,0,0,2
"PRK",2000,3,1,0,4
"QAT",2000,1,0,0,1
"ROU",2000,13,6,27,46
"RSA",2000,3,2,0,5
"RUS",2000,54,68,66,188
"SLO",2000,0,0,3,3
"SRI",2000,0,1,0,1
"SUI",2000,2,11,1,14
"SVK",2000,1,3,2,6
"SWE",2000,8,20,4,32
"THA",2000,2,0,1,3
"TPE",2000,4,1,0,5
"TRI",2000,1,1,0,2
"TUR",2000,2,0,3,5
"UKR",2000,12,20,3,35
"URU",2000,0,1,0,1
"USA",2000,52,66,130,248
"UZB",2000,2,1,1,4
"VIE",2000,0,1,0,1
"YUG",2000,13,1,12,26
"ARG",2004,21,0,26,47
"AUS",2004,30,78,49,157
"AUT",2004,1,4,3,8
"AZE",2004,4,0,1,5
"BAH",2004,1,0,1,2
"BEL",2004,2,0,1,3
"BLR",2004,9,6,2,17
"BRA",2004,3,19,18,40
"BUL",2004,14,1,2,17
"CAN",2004,4,10,3,17
"CHI",2004,1,0,3,4
"CHN",2004,15,27,52,94
"CMR",2004,0,0,1,1
"COL",2004,2,0,0,2
"CRO",2004,3,3,14,20
"CUB",2004,22,8,31,61
"CZE",2004,5,6,1,12
"DEN",2004,10,0,19,29
"DOM",2004,0,0,1,1
"EGY",2004,3,1,1,5
"ERI",2004,1,0,0,1
"ESP",2004,8,15,4,27
"EST",2004,2,1,0,3
"ETH",2004,2,3,2,7
"FIN",2004,0,2,0,2
"FRA",2004,22,10,21,53
"GBR",2004,15,25,17,57
"GEO",2004,0,2,2,4
"GER",2004,63,45,41,149
"GRE",2004,5,18,8,31
"HKG",2004,0,2,0,2
"HUN",2004,4,12,24,40
"INA",2004,3,1,1,5
"IND",2004,0,1,0,1
"IRI",2004,2,2,2,6
"ISR",2004,1,0,1,2
"ITA",2004,39,39,24,102
"JAM",2004,6,1,6,13
"JPN",2004,53,20,21,94
"KAZ",2004,3,4,1,8
"KEN",2004,2,4,1,7
"KOR",2004,10,28,14,52
"LAT",2004,0,4,0,4
"LTU",2004,0,2,1,3
"MAR",2004,0,1,2,3
"MEX",2004,1,3,0,4
"MGL",2004,1,0,0,1
"NED",2004,22,50,4,76
"NGR",2004,8,0,0,8
"NOR",2004,2,0,5,7
"NZL",2004,0,2,4,6
"PAR",2004,0,17,0,17
"POL",2004,6,2,4,12
"POR",2004,1,2,0,3
"PRK",2004,1,4,0,5
"ROU",2004,11,5,23,39
"RSA",2004,3,3,4,10
"RUS",2004,96,49,47,192
"SCG",2004,0,14,0,14
"SLO",2004,3,2,0,5
"SUI",2004,4,2,1,7
"SVK",2004,5,2,3,10
"SWE",2004,2,5,5,12
"SYR",2004,1,0,0,1
"THA",2004,4,1,3,8
"TPE",2004,3,4,2,9
"TRI",2004,1,0,0,1
"TUR",2004,4,3,3,10
"UAE",2004,0,0,1,1
"UKR",2004,31,8,9,48
"USA",2004,73,75,116,264
"UZB",2004,2,1,2,5
"VEN",2004,2,0,0,2
"ZIM",2004,1,1,1,3
"AFG",2008,1,0,0,1
"ALG",2008,1,1,0,2
"ARG",2008,31,0,20,51
"ARM",2008,6,0,0,6
"AUS",2008,76,42,31,149
"AUT",2008,2,1,0,3
"AZE",2008,4,2,1,7
"BAH",2008,1,4,0,5
"BEL",2008,0,4,1,5
"BLR",2008,17,5,8,30
"BRA",2008,27,34,14,75
"BUL",2008,3,1,1,5
"CAN",2008,10,13,11,34
"CHI",2008,0,1,0,1
"CHN",2008,57,53,74,184
"CMR",2008,0,0,1,1
"COL",2008,1,1,0,2
"CRO",2008,3,2,0,5
"CUB",2008,11,34,2,47
"CZE",2008,0,4,3,7
"DEN",2008,6,6,6,18
"DOM",2008,0,1,1,2
"ECU",2008,0,1,0,1
"EGY",2008,1,0,0,1
"ESP",2008,16,48,7,71
"EST",2008,0,2,1,3
"ETH",2008,2,1,4,7
"FIN",2008,2,2,1,5
"FRA",2008,28,23,25,76
"GBR",2008,21,25,31,77
"GEO",2008,3,0,3,6
"GER",2008,43,16,42,101
"GRE",2008,4,3,0,7
"HUN",2008,3,8,16,27
"INA",2008,3,2,2,7
"IND",2008,2,0,1,3
"IRI",2008,1,0,1,2
"IRL",2008,2,1,0,3
"ISL",2008,0,14,0,14
"ISR",2008,1,0,0,1
"ITA",2008,20,14,8,42
"JAM",2008,5,3,9,17
"JPN",2008,17,11,23,51
"KAZ",2008,7,4,2,13
"KEN",2008,4,4,6,14
"KGZ",2008,1,1,0,2
"KOR",2008,26,11,41,78
"LAT",2008,1,1,1,3
"LTU",2008,3,2,0,5
"MAR",2008,1,1,0,2
"MAS",2008,0,1,0,1
"MDA",2008,1,0,0,1
"MEX",2008,2,0,2,4
"MGL",2008,0,2,2,4
"MRI",2008,1,0,0,1
"NED",2008,4,18,40,62
"NGR",2008,6,18,0,24
"NOR",2008,1,5,16,22
"NZL",2008,8,2,4,14
"PAN",2008,0,0,1,1
"POL",2008,1,13,6,20
"POR",2008,0,1,1,2
"PRK",2008,3,1,2,6
"ROU",2008,16,1,5,22
"RSA",2008,0,1,0,1
"RUS",2008,56,44,43,143
"SIN",2008,0,3,0,3
"SLO",2008,2,2,1,5
"SRB",2008,14,1,0,15
"SUD",2008,0,1,0,1
"SUI",2008,8,0,3,11
"SVK",2008,1,5,4,10
"SWE",2008,2,5,0,7
"THA",2008,0,2,2,4
"TJK",2008,1,1,0,2
"TOG",2008,1,0,0,1
"TPE",2008,4,0,0,4
"TRI",2008,0,5,0,5
"TUN",2008,0,0,1,1
"TUR",2008,3,4,1,8
"UKR",2008,16,5,10,31
"USA",2008,81,109,125,315
"UZB",2008,3,2,1,6
"VEN",2008,1,0,0,1
"VIE",2008,0,1,0,1
"ZIM",2008,0,3,1,4
